NO ./assets/wall.png
SO ./assets/textures/SOWALL.xpm
WE ./assets/textures/WEWALL.xpm
EA ./assets/textures/EAWALL.xpm

C 52,174,235
F 71,73,74


11111111111111111111111111111111111111111111111111111111111111111111111111111111111111111111111111111
10000000001100000000000000000000000000000000000000000000000000000000000000000000000000000000000000001
10000000000000000000000000000000000000000000000000000000000000000000000000000000000000000000000000001
10110000011100000000000001000000000000000000000000000000000000000000000000000000000000000000000000001
10000001111111111100000010000000000000000000000000000000000000000000000000000000000000000000000000001
10000001         100000000000000000111111111100000000000000000000000000000000000000000000000000000001
10000001         100000000000000000000000000000000000000000000000000000000000000000000000000000000001
10000001         100000000000000000000000000000000000000000000000000000000000000000000000000000000001
10000001         100000000000000000000000000000000000000000000000000000000000000000000000000000000001
1000000111111111100000000000000000000000000000000111111111100000000000000000000000000000000000000001
10000000000000000001000000000000000000000000000000000000000000000000000000000000000000000000000000001
10000000000000000000100000000000000000000000000000000000000000000000000000000000000000000000000000001
10000001111111111100000000000000000000000000000000000000000000000000000000000000000000000000000000001
10000001         100000000000000000000000000000000000000000000000000000000000000000000000000000000001
10000001         1000000000000000000000000000000000000N0000000000000000000000000000000000000000000001
10000001         100000000000000000000000000000000000000000000000000000000000000000000000000000000001
10000001         100000000000000000000000000000000000000000000000000000000000000000000000000000000001
10000001111111111100000000000000000000000000000000000000000000000000000000000000000000000000000000001
10000000000000000000000000000000000000000000000000000000000000000000000000000000000000000000000000001
11110111111111011100000011111111111111111111111111111111111111111111111111111111111111111111111111111
11110111111111011101010010001
11000000110101011100000000001
10000000000000001100000010001
10000000000000001100000010001
100000000000000011010100100011111
110000011101010101110111100000001
11110111 111010111 1111 100011101
11111111 1111111 111111111111 111
