NO ./assets/wall2.xpm42
SO ./assets/wall2.xpm42
WE ./assets/wall2.xpm42
EA ./assets/wall2.xpm42
D  ./assets/door2.xpm42

C 179,198,232
F 92,71,83

11111111111111111111111111111111111111111111111111111111111111111111111111111111111111111111111111111
10000000001100000000000000000000000000000000000000000000000000000000000000000000000000000000000000001
10000000000000000000000000000000000000000000000000000000000000000000000000000000000000000000000000001
10110000011100000000000000000000000000000000000000000000000000000000000000000000000000000000000000001
10000001111111111100000000000000000000000000000000000000000000000000000000000000000000000000000000001
10000001         100000000000000000111D11111000000000000000000000000000000000000000000000000000000001
10000001         100000000000000000D1101111D000000000000000000000000000000000000000000000000000000001
10000001         100000001000000000111D11111000000000000000000000000000000000000000000000000000000001
10000001         1000000001000000000000000000000000000000000000000W0000000000000000000000000000000001
10000001111111111100000000000000000000000000000000111111111100000000000000000000000000000000000000001
10000000000000000001000000000000000000000000000000000000000000000000000000000000000000000000000000001
10000000000000000000100000000000000000000000000000000000000000000000000000000000000000000000000000001
10000001111111111100000000000000000000000000000000000000000000000000000000000000000000000000000000001
10000001         100000000000000000000000000000000000000000000000000000000000000000000000000000000001
10000001         100000000000000000000000000000000000000000000000000000000000000000000000000000000001
10000001         100000000000000000000000000000000000000000000000000000000000000000000000000000000001
10000001         100000000000000000000000000000000000000000000000000000000000000000000000000000000001
10000001111111111100000000000000000000000000000000000000000000000000000000000000000000000000000000001
10000000000000000000000000000000000000000000000000000000000000000000000000000000000000000000000000001
11110111111111011100000011111111111111111111111111111111111111111111111111111111111111111111111111111
11110111111111011101010010001
11000000110101011100000000001
10000000000000001100000010001
10000000000000001100000010001
100000000000000011010100100011111
110000011101010111110111100000001
11110111 1110101 1 1111 100011101
11111111 1111111 111111111111 111
