NO ./assets/88.xpm42
SO ./assets/wall.xpm42
WE ./assets/wall.xpm42
EA ./assets/bluestone.xpm42

C 46,71,99
F 71,73,74

11111111111111111111110111111111111111111111
10000000001100000000001000000000000000000001
10000000000000000000000000000000N00000000001
10110000011100000000000000000000000000000001
1111111111111111111111111111111111111111111