NO ./assets/textures/Bark.xpm
SO ./assets/textures/Bricks.xpm
WE ./assets/textures/Dirt.xpm
EA ./assets/textures/Coal.xpm

C 51,53,51
F 255,0,0

11111111111111111111111111111111111111111
10000000000000000000000000000000000000001
10000000000000000000000100000000000000001
100000000000000000000010000W0000000000001
11111111111111111110000000111111111111111
1111111111111111111111111111