NO  ./assets/textures/backrooms.png
WE  ./assets/textures/backrooms.png
EA  ./assets/textures/backrooms.png
SO  ./assets/textures/backrooms.png

F 105,92,36
C 148,147,85



1111111111111111
1111111111111111
1111111111111111