NO ./assets/clean_assets/famine.xpm42
SO ./assets/clean_assets/makima.xpm42
WE ./assets/clean_assets/reze.xpm42
EA ./assets/clean_assets/sawatari.xpm42

C 51,53,12
F 36,85,30

111111111111111111111111111111111111111
100000000000000000000000000000000000001
100000010000000000000E00000001000000001
100000010000000000000000000001000000001
100000010000000000100000000001000000001
100001000000000000100000000000000000001
100001000000000000111110000000000000001
100001000000000000000000000000000000001
111111111111111111111111111111111111111
