NO ./assets/textures/NOWALL.xpm
SO ./assets/textures/SOWALL.xpm
WE ./assets/textures/WEWALL.xpm
EA ./assets/textures/EAWALL.xpm

C 52,174,235
F 71,73,74






11111111111111111111111111111111111111111111111111111111111111111111111111111111111111111111111111111