NO ./assets/wardevil.xpm42
SO ./assets/wardevil.xpm42
WE ./assets/wardevil.xpm42
EA ./assets/wardevil.xpm42

C 52,174,235
F 71,73,74






11111111111111111111111111111111111111111111111111111111111111111111111111111111111111111111111111111
1110000000W000000000000000000000111111111111111111111111111111111111
11111111111111111111111111111111111111111111111111111111111111111111111111111111111111111111111111111