NO  ./assets/textures/backrooms.png
WE  ./assets/textures/backrooms.png
EA  ./assets/textures/backrooms.png
SO  ./assets/textures/backrooms.png
C 148,147,85
F 105,92,36

1111111111
1010100001
1111111111
1111111111






